40
40
0 0 12 13 13 6 6 6 6 13 13 13 13 6 6 6 13 13 13 13 13 13 6 6 6 6 6 6 6 6 6 6 6 6 6 6 6 6 6 6 
0 0 3 3 3 12 13 13 14 3 3 3 3 12 13 14 3 3 3 3 3 3 12 13 13 13 13 6 6 6 6 6 13 13 13 6 6 6 6 6 
9 3 3 3 3 3 1 1 3 3 3 3 3 3 1 3 3 15 3 3 3 15 3 3 3 3 3 12 6 6 6 14 3 3 3 12 6 6 6 6 
11 3 3 3 3 3 1 1 3 3 3 3 3 3 1 3 2 3 3 3 3 3 3 3 3 3 3 3 12 13 14 3 3 3 15 3 12 13 13 6 
6 8 9 3 3 7 8 8 9 3 3 3 3 7 8 9 3 3 3 15 3 3 7 8 9 3 3 3 3 1 3 3 3 3 3 3 3 3 3 10 
6 6 11 3 3 10 6 6 6 9 3 3 7 6 6 11 3 3 3 3 3 3 10 6 11 3 3 3 3 1 3 3 3 3 15 3 3 3 3 10 
6 6 11 1 1 10 6 6 6 11 3 3 12 13 6 11 3 5 3 3 3 3 10 6 11 3 3 3 7 8 9 3 15 3 3 3 5 3 3 10 
6 6 11 3 3 10 6 6 6 14 3 3 3 3 12 13 8 6 8 9 3 3 10 6 6 9 3 7 6 6 6 9 3 3 3 7 14 3 3 10 
6 6 14 3 3 12 6 6 11 3 3 19 18 3 2 3 12 6 6 11 3 3 10 6 6 11 3 10 6 6 6 6 8 8 8 11 3 3 3 10 
6 14 3 3 3 3 12 6 11 3 3 3 3 3 2 3 3 12 6 11 3 3 12 13 13 14 3 12 13 13 13 13 13 13 13 14 3 3 7 6 
11 3 3 7 9 3 3 12 14 3 7 8 8 8 9 3 3 3 10 11 1 1 3 3 3 3 3 3 3 3 3 3 1 3 3 3 3 3 10 6 
11 3 3 12 14 3 3 3 3 1 10 6 6 6 6 9 3 3 12 14 3 3 3 3 3 3 3 3 3 3 3 3 1 3 3 15 3 3 10 6 
6 9 3 3 3 3 7 8 8 8 6 13 13 13 13 13 9 1 3 3 19 8 8 8 9 3 3 7 8 8 8 8 8 9 3 3 3 3 10 6 
6 6 9 3 3 7 6 6 6 6 14 3 3 3 3 3 10 8 9 3 3 10 6 6 11 3 3 12 13 13 6 6 6 6 9 3 3 3 10 6 
6 6 11 1 1 10 6 6 6 14 1 3 3 3 15 3 10 6 11 3 3 10 6 6 11 3 3 3 3 3 10 6 6 6 6 9 3 3 10 6 
6 6 11 1 1 10 6 13 14 3 1 5 3 3 3 3 12 6 14 1 1 12 6 6 11 3 3 3 3 3 10 6 6 6 6 6 8 8 6 6 
6 6 14 3 3 12 11 3 3 3 7 6 9 3 15 3 3 20 1 1 1 1 12 6 6 8 9 3 3 3 12 13 13 13 13 13 6 6 6 6 
6 11 3 3 3 3 20 3 3 7 6 6 6 9 3 3 3 1 1 1 1 1 1 12 6 6 13 9 3 1 3 3 3 3 3 3 10 6 6 6 
6 11 3 3 3 3 2 3 7 6 6 6 6 6 9 3 1 1 1 1 1 1 1 1 12 14 3 12 9 3 7 8 8 9 3 3 10 6 6 6 
6 11 3 15 3 3 3 7 6 6 6 13 13 13 14 1 1 1 1 4 4 1 1 1 1 3 3 3 20 3 10 6 13 14 3 3 10 6 6 6 
6 11 3 3 3 3 7 6 6 6 11 3 3 3 3 1 1 1 1 4 4 1 1 1 1 3 15 3 2 3 10 11 3 3 3 3 10 6 6 6 
6 6 8 9 3 7 6 6 6 6 11 3 3 3 7 9 1 1 1 1 1 1 1 1 5 3 3 3 7 8 6 14 3 3 3 3 10 6 6 6 
6 6 6 11 3 10 6 6 6 6 11 3 3 7 6 6 9 1 1 1 1 1 1 7 6 9 3 7 6 6 11 3 3 3 7 8 6 6 6 6 
6 6 6 11 1 10 6 6 6 6 11 3 3 10 6 6 6 9 1 1 1 1 7 6 6 6 8 6 6 6 11 3 3 3 12 6 6 6 6 6 
6 6 6 11 3 12 13 13 6 6 11 3 3 10 6 6 6 6 9 1 1 19 6 6 6 6 6 6 6 6 6 9 3 3 3 12 6 6 6 6 
6 6 6 14 3 3 3 3 10 13 14 3 3 10 6 6 6 6 11 3 3 3 10 6 6 6 6 6 6 6 6 6 9 3 3 3 12 13 6 6 
6 6 14 3 3 7 9 3 16 3 1 3 3 10 6 6 6 6 11 3 3 3 12 6 6 6 6 6 6 6 6 6 6 18 3 2 3 3 12 6 
6 11 3 3 7 6 11 3 20 3 1 3 3 10 6 6 6 6 6 8 9 3 3 10 13 13 13 6 6 6 6 6 11 3 3 3 3 3 3 10 
6 11 3 7 6 6 11 3 3 3 7 8 8 6 6 6 6 6 6 6 14 1 1 20 3 3 3 12 6 6 6 6 6 18 3 15 3 3 19 6 
6 11 3 10 6 6 6 9 3 3 12 13 6 6 6 6 6 6 6 14 3 2 2 3 3 3 15 3 12 6 6 6 11 3 3 3 3 3 3 10 
6 11 3 10 6 6 6 6 9 3 3 3 12 6 6 6 6 6 11 3 15 3 3 3 15 3 3 3 3 12 6 6 6 18 3 3 15 3 19 6 
6 11 3 10 6 6 6 6 6 9 3 3 3 12 6 6 6 6 14 3 3 3 15 3 3 3 15 3 3 3 10 6 11 3 3 3 3 3 3 10 
6 11 3 12 13 6 6 6 6 6 9 3 3 3 12 6 6 14 3 3 15 3 3 3 15 3 3 3 15 3 10 6 6 8 9 1 1 7 8 6 
6 11 3 3 3 12 13 13 6 6 6 9 3 3 3 12 14 3 3 3 3 3 15 3 3 3 15 3 3 3 12 13 13 13 14 3 3 10 6 6 
6 6 8 9 3 3 3 3 10 6 6 6 9 3 3 3 3 3 3 3 15 3 3 3 15 3 3 3 15 2 3 3 3 3 3 3 3 10 6 6 
6 6 6 11 3 1 1 3 12 13 13 13 14 3 3 3 3 3 3 3 3 3 3 3 3 3 3 3 3 2 3 3 3 3 3 3 3 12 13 6 
6 6 6 11 3 1 1 3 3 3 3 3 3 3 3 7 9 3 3 3 3 3 3 3 3 3 3 3 15 3 3 3 3 3 3 3 3 3 3 10 
6 6 6 11 3 3 3 3 7 8 8 8 8 8 8 6 11 3 3 3 3 3 3 3 3 3 3 3 3 3 7 8 8 8 9 3 3 3 3 12 
6 6 6 6 8 8 8 8 6 6 6 6 6 6 6 6 6 8 8 8 8 8 8 9 3 3 3 3 3 3 10 6 6 6 6 9 3 3 0 0 
6 6 6 6 6 6 6 6 6 6 6 6 6 6 6 6 6 6 6 6 6 6 6 6 8 8 8 8 8 8 6 6 6 6 6 6 8 9 0 0 