30
30
0 0 12 6 6 6 13 6 6 6 6 6 6 6 6 6 6 6 6 6 6 6 6 6 6 6 6 6 6 6 
0 0 3 12 13 14 3 10 6 6 6 6 6 6 6 6 6 6 6 6 6 6 6 6 6 6 6 6 6 6 
9 3 3 3 3 3 3 12 13 6 6 13 13 13 13 13 13 13 13 13 13 13 13 13 13 6 6 6 6 6 
6 9 3 3 7 9 3 3 3 10 11 3 3 3 3 3 3 3 3 3 3 3 3 3 3 10 6 6 6 6 
6 6 9 3 10 6 8 9 3 12 14 3 7 8 8 8 9 3 3 3 3 3 3 3 3 10 6 6 6 6 
6 6 14 3 12 6 6 11 3 3 3 3 10 6 6 6 11 3 7 8 8 8 8 9 3 10 6 6 6 6 
6 11 3 3 3 10 6 11 3 7 9 3 12 13 13 13 14 3 10 6 13 13 13 14 3 12 13 13 6 6 
6 11 3 5 3 10 13 14 3 10 11 3 3 3 3 3 3 3 10 11 3 3 3 3 3 3 3 3 10 6 
6 14 3 16 3 20 3 3 3 10 6 17 17 17 17 18 3 3 12 11 3 19 17 18 3 7 9 3 10 6 
11 3 3 16 3 3 3 15 3 10 11 1 1 1 1 1 1 3 1 16 3 3 3 3 3 10 11 3 10 6 
6 8 8 11 3 5 3 3 3 10 11 1 1 1 1 1 1 1 1 16 3 19 17 18 3 12 14 3 10 6 
6 6 6 14 3 12 8 9 3 10 11 1 1 1 1 1 1 1 1 16 3 3 3 3 3 3 3 3 10 6 
6 6 11 3 3 3 10 11 3 10 14 1 1 1 1 1 1 1 1 10 8 8 8 9 3 7 8 8 6 6 
6 6 11 3 5 3 12 14 3 16 3 1 1 1 1 4 4 1 1 10 6 6 6 14 3 12 6 6 6 6 
6 6 11 3 16 3 3 3 3 16 3 1 1 1 1 4 4 1 1 10 6 13 14 3 3 3 12 13 6 6 
6 6 14 3 12 8 8 9 3 16 3 1 1 3 1 1 1 1 1 10 11 3 3 3 3 3 3 3 10 6 
6 11 3 3 3 10 6 11 3 16 3 3 3 3 19 17 8 17 17 13 11 3 7 9 3 7 9 3 10 6 
6 11 3 15 3 10 6 11 3 16 3 7 9 3 3 3 16 3 3 3 16 3 10 11 3 10 11 3 10 6 
6 11 3 3 3 10 13 14 3 20 3 12 14 3 5 3 16 3 5 3 16 3 10 11 3 10 11 3 10 6 
6 6 9 3 7 11 3 3 3 3 3 3 3 3 16 3 20 3 16 3 20 3 10 11 3 10 11 3 10 6 
6 6 11 3 12 14 3 7 8 8 8 8 8 8 11 3 3 3 16 3 3 3 10 11 3 10 11 3 10 6 
6 6 11 3 3 3 3 10 6 6 6 6 6 6 6 8 8 8 6 8 8 8 6 11 3 10 11 3 10 6 
6 6 6 9 3 3 7 6 6 6 6 6 6 6 6 6 6 6 6 6 6 6 6 11 3 12 14 3 10 6 
6 6 6 11 3 3 10 6 6 6 6 6 6 6 6 6 6 6 6 6 6 6 6 11 3 3 3 3 10 6 
6 6 6 11 3 3 10 6 6 13 13 13 6 13 13 13 6 13 13 13 6 13 13 13 8 8 9 3 10 6 
6 6 6 11 3 3 12 13 14 3 3 3 20 3 3 3 20 3 3 3 20 3 3 3 12 13 11 3 10 6 
6 6 6 6 9 3 3 3 3 3 5 3 3 3 5 3 3 3 5 3 3 3 5 3 3 3 20 3 12 6 
6 6 6 6 6 8 8 8 8 8 6 8 8 8 6 8 8 8 6 8 8 8 6 8 9 3 3 3 3 12 
6 6 6 6 6 6 6 6 6 6 6 6 6 6 6 6 6 6 6 6 6 6 6 6 6 9 3 3 0 0 
6 6 6 6 6 6 6 6 6 6 6 6 6 6 6 6 6 6 6 6 6 6 6 6 6 6 8 9 0 0 