10
10
0 0 12 13 14 3 2 3 12 13 
0 0 3 3 3 3 5 3 3 3 
8 8 8 17 17 17 13 17 18 3 
6 6 11 1 1 1 1 3 3 3 
6 13 14 1 4 4 1 3 3 7 
11 3 3 1 4 4 1 7 8 6 
14 3 3 1 1 1 1 10 6 6 
3 3 19 17 17 8 17 13 13 13 
3 15 3 2 3 20 3 3 0 0 
3 3 3 5 3 3 3 3 0 0 