20
20
0 0 12 13 13 13 13 13 13 13 13 13 13 6 6 6 6 6 6 6 
0 0 3 3 3 3 3 3 3 3 3 3 3 10 6 6 6 6 6 6 
9 3 3 19 17 17 8 8 8 17 17 9 3 12 13 13 13 13 6 6 
11 3 3 3 3 3 10 6 11 3 3 20 2 3 3 3 3 3 10 6 
11 3 19 18 3 3 10 6 11 3 3 3 3 5 3 3 3 3 10 6 
11 3 3 3 3 3 10 6 11 3 3 7 8 6 8 9 3 7 6 6 
11 3 3 19 18 3 10 13 14 3 3 10 6 6 13 14 3 12 13 6 
11 3 3 3 3 3 16 1 1 1 1 10 6 11 3 3 3 3 3 10 
11 3 3 15 3 3 16 1 4 4 1 10 6 11 3 15 3 15 3 10 
6 9 3 2 3 7 11 1 4 4 1 10 6 11 3 3 3 3 3 10 
6 6 18 3 19 6 11 1 1 1 1 10 6 11 3 15 3 15 3 10 
6 11 3 3 3 10 6 9 3 3 7 6 6 11 3 3 3 3 3 10 
6 11 3 3 3 10 6 14 3 3 10 6 6 11 3 15 3 15 3 10 
6 11 3 3 3 10 14 3 3 3 10 6 6 11 3 3 3 3 3 10 
6 6 9 3 19 14 3 3 3 7 6 6 6 6 8 18 2 19 8 6 
6 6 11 3 3 3 3 3 7 6 6 6 6 6 11 3 3 3 10 6 
6 6 11 3 19 17 17 17 13 13 13 13 13 13 14 3 3 3 12 6 
6 6 11 2 3 3 3 3 3 3 3 3 3 3 3 3 3 3 3 12 
6 6 6 8 8 8 8 8 8 8 8 8 8 8 8 8 9 3 0 0 
6 6 6 6 6 6 6 6 6 6 6 6 6 6 6 6 6 9 0 0 